mxi emtoree ee professi eunt aflne meneie Novembrium,
neque ed meneem uejum 10⁶9.

Am e tp en: Die Bnebhendlung von Max Komicker.
Augeburgz Die M. Rieger’eehe Buehhmdlung.
Besel: Die Buehheudlung eon J. G. Neukireh.
„ Schweighweer'eche Buchhendlung.
Berlin: Die Buchhendlnng von Δ. Aeher ὁ 0⁰· 8 Exempl.
„ Voee'eehe Summanu-Buehhmdlung.
Bern: Die Buehhendlung eon Habet ἃ 0⁰·
Breflenz: Die Buchhendlnng von J. N. Teuteeh.
Bremen: Die Buehhendlung von J. G. Heyee.
Breeleu: Die Buehhendlung eon F. ffire
,‚ „ ,, Mu ὁ 0⁰·
Bromberg: Die Mittlet'eehe Buehheudlung.
Brfieeel: Die Buehhmdlung von Kieeeling ἁ 0⁰·
„ Buehhendlung von G. Muquudt.
Bfiekeburg: Hert Geh. ιαμ-Κακὴ V. von Smuee.
Gerleruhe: Die Breun’eehe Hofbuchhendlung.
‚. Geeener'eehe Buehhendlung. Ι
Greeeu: Die Buehhendlung von D. E. Friedlein.
Danti g: Die Buehhendlung von F. Δ. Weber.
Dermetedt: Die Hofbuehhendlung von G. Jonghm.
Dorpet: Die Buehhendlung von E. F. Κεῖον. .
Elberfel d: Hert Direetor Dr. Ph. Wackernagel fflr die Reeleehule.
Franksnrt e. u: Die Biblioehek dee Gymnasium. ·
„ stedtbihlioehek durch die Buehhendlung vnn Th. Veleker.
Der Physieelieehe Verein durch die Seuerundes·eehessuohhend1ung.
Freiburg: Die Wagner’eche Buehhendlung 2 Exempl.
Gens: Hert Prot. E. Plantemour durch die Buehhendlung von Keeemenn.
Greetz: Die Heeee'eehe Buehhendlnng noeh 1 Exempl.
Groningen: Die Academieche Bibliothek durch Th. Thomu in Leipzig.
Hemb ur g: Die Buchhandlung eon Neetlet ἁ Melle.
„ Astur librery in Ner-York d ch Ρ nh B &Hm
nen οι. Moe. nonem ¹¹¹ ⁸ ‘⁸’ „⁰⁸¹” ⁶· ¹
Haneu: Dee Gymnasium durch Herm Direetor Piderit.
Heidelberg: Die Universitets·Bibliothek dureh die Emmerling'eehe Buehhendlunss.
Belsingfore: Die Buchhendlung von Weeeniue ἁ 0⁰·
Inneb ruek: Die Wagner'eche Buchhendlung.

 

